"filename", "language", "C#", "comment", "blank", "total"
"d:\3. SAP\Moonweaver\Assets\+++Workdata\Scripts\Companion\CompanionBehaviour.cs", "C#", 29, 12, 5, 46
"d:\3. SAP\Moonweaver\Assets\+++Workdata\Scripts\Enemies\EnemyBehaviour.cs", "C#", 19, 3, 7, 29
"d:\3. SAP\Moonweaver\Assets\+++Workdata\Scripts\Enemies\EnemyInfos.cs", "C#", 124, 44, 19, 187
"d:\3. SAP\Moonweaver\Assets\+++Workdata\Scripts\Interactables\ShrineBehaviour.cs", "C#", 34, 15, 5, 54
"d:\3. SAP\Moonweaver\Assets\+++Workdata\Scripts\Items\ItemBehaviour.cs", "C#", 24, 0, 5, 29
"d:\3. SAP\Moonweaver\Assets\+++Workdata\Scripts\Items\ItemScriptableObject.cs", "C#", 9, 0, 1, 10
"d:\3. SAP\Moonweaver\Assets\+++Workdata\Scripts\MainMenu\MenuButtons.cs", "C#", 82, 4, 8, 94
"d:\3. SAP\Moonweaver\Assets\+++Workdata\Scripts\MainMenu\SaveFileSlot.cs", "C#", 7, 0, 2, 9
"d:\3. SAP\Moonweaver\Assets\+++Workdata\Scripts\Player\PlayerCombat.cs", "C#", 177, 55, 31, 263
"d:\3. SAP\Moonweaver\Assets\+++Workdata\Scripts\Player\PlayerController.cs", "C#", 233, 75, 58, 366
"d:\3. SAP\Moonweaver\Assets\+++Workdata\Scripts\Player\PlayerHealthflaskBehaviour.cs", "C#", 42, 26, 9, 77
"d:\3. SAP\Moonweaver\Assets\+++Workdata\Scripts\Player\PlayerInfos.cs", "C#", 119, 41, 22, 182
"d:\3. SAP\Moonweaver\Assets\+++Workdata\Scripts\Player\PlayerInteract.cs", "C#", 31, 10, 10, 51
"d:\3. SAP\Moonweaver\Assets\+++Workdata\Scripts\Player\PlayerLevelBehaviour.cs", "C#", 120, 59, 22, 201
"d:\3. SAP\Moonweaver\Assets\+++Workdata\Scripts\Player\PlayerMeleeWeaponBehaviour.cs", "C#", 79, 38, 16, 133
"d:\3. SAP\Moonweaver\Assets\+++Workdata\Scripts\Player\PlayerRangedWeaponBehaviour.cs", "C#", 32, 25, 11, 68
"d:\3. SAP\Moonweaver\Assets\+++Workdata\Scripts\Player\Projectile\ProjectileBehaviour.cs", "C#", 40, 22, 10, 72
"d:\3. SAP\Moonweaver\Assets\+++Workdata\Scripts\Player\TakeDamageBehaviour.cs", "C#", 20, 12, 4, 36
"d:\3. SAP\Moonweaver\Assets\+++Workdata\Scripts\UI\Dialogue\ButtonBehaviour.cs", "C#", 22, 0, 7, 29
"d:\3. SAP\Moonweaver\Assets\+++Workdata\Scripts\UI\Dialogue\DialogueManager.cs", "C#", 91, 3, 18, 112
"d:\3. SAP\Moonweaver\Assets\+++Workdata\Scripts\UI\Dialogue\NPCDialogueBehaviour.cs", "C#", 40, 0, 10, 50
"d:\3. SAP\Moonweaver\Assets\+++Workdata\Scripts\UI\Inventory\InventoryManager.cs", "C#", 30, 0, 5, 35
"d:\3. SAP\Moonweaver\Assets\+++Workdata\Scripts\UI\Inventory\InventorySlot.cs", "C#", 41, 2, 9, 52
"d:\3. SAP\Moonweaver\Assets\+++Workdata\Scripts\UI\Levelling\LevelUpManager.cs", "C#", 112, 7, 7, 126
"d:\3. SAP\Moonweaver\Assets\+++Workdata\Scripts\UI\Levelling\LevelUpSlot.cs", "C#", 50, 0, 11, 61
"d:\3. SAP\Moonweaver\Assets\+++Workdata\Scripts\UI\PlayerBars\DisplayHeldMoonlight.cs", "C#", 13, 0, 4, 17
"d:\3. SAP\Moonweaver\Assets\+++Workdata\Scripts\UI\PlayerBars\DisplayMoonwaterAmount.cs", "C#", 13, 0, 3, 16
"d:\3. SAP\Moonweaver\Assets\+++Workdata\Scripts\UI\PlayerBars\StatBarBehaviour.cs", "C#", 88, 1, 9, 98
"Total", "-", 1721, 454, 328, 2503